https://www.dataroma.com/m/home.php

BRK.B - Berkshire Hathaway CL B
AXP - American Express
MA - Mastercard Inc
BAC - Bank of America Corp
RACE - Ferrari NV
MU - Micron Technology Inc
BRK.A - Berkshire Hathaway CL A
MCO - Moody's Corp
BABA - Alibaba Group Holdings
DJCO - Daily Journal Corp
GOOGL - Alphabet Inc
SRG - Seritage Growth Properties
AMR - Alpha Metallurgical Resources Inc
CNR - Core Natural Resources Inc

CVS - CVS Health Corp
BAX - Baxter International Inc
FMS - Fresenius Medical Care AG & Co KCaG
C - Citigroup Inc
HUM - Humana Inc.
DG - Dollar General
COF - Capital One Financial
WFC - Wells Fargo
MGA - Magna International Inc.
GPN - Global Payments Inc.
CRBG - Corebridge Financial Inc.
MET - MetLife Inc.
DOW - Dow Inc.
SWKS - Skyworks Solutions Inc.
CTSH - Cognizant Technology Solutions
LEA - Lear Corp.
SHEL - Shell plc
SSNC - SS&C Technologies Holdings Inc.
CHTR - Charter Communications
DOX - Amdocs Ltd.
BMY - Bristol-Myers Squibb
MDT - Medtronic plc
PFE - Pfizer Inc.
TSN - Tyson Foods
TEL - TE Connectivity plc
VOYA - Voya Financial Inc.
DAL - Delta Air Lines Inc.
NOV - Nov Inc.
UBS - UBS AG
PVH - PVH Corp.
EQH - Equitable Holdings Inc.
NWL - Newell Brands Inc.
